Specimen received	type=SpecimensReceived
Specimens received	type=SpecimensReceived
Accession Number	type=AccessionNumber
Accession No	type=AccessionNumber
Clinical Details	type=ClinicalDetails
Macro Description	type=MacroDescription
Macroscopy	type=MacroDescription
Microscopy	type=Microscopy
Technical	type=Technical
Supplementary Report	type=SupplementaryReport
Supplementary report	type=SupplementaryReport
Supplemental report	type=SupplementaryReport
Amended report	type=SupplementaryReport
Ammended report	type=SupplementaryReport
Amendment	type=SupplementaryReport
Ammendment	type=SupplementaryReport
Additional report	type=SupplementaryReport
Addendum	type=SupplementaryReport
Specimen review		type=SupplementaryReport
Supplementary report: specimen review	type=SupplementaryReport
